F 100,200,255
NO ./textures/ratt.png

WE ./textures/dots.png
SO ./textures/ratt.png
EA ./textures/dots.png

C 100,200,255





11111
10101
10001
100N1
11111