F 100,200,255
NO ./textures/ratt.png

WE ./textures/dots.png
SO ./textures/ratt.png
EA ./textures/dots.png

C 100,200,255


        1111111111111111111111111
        1000000000110000000000001
        1011000000111000000000001
        1001000000000000000000001
111111111011000001110000000000001
100000000011000001110111110111111
11110111111111011100000010001
11110111111111011101010000001
11000000110101011100000010001
10000000000000001100000010001
10000000000000 00001010010001
11000001110001011111011110N01  
10010001 1000101 101111010001
11111111 1111111 111111111111



