F 100,200,255
NO ./maps/textures/ratt.png

WE ./maps/textures/dots.png
SO ./maps/textures/ratt.png
EA ./maps/textures/dots.png

C 100,200,255


        1111111111111111111111111
        1000000000110000000000001
        1011000000111000000000001
        1001000000000000000000001
111111111011000001110000000000001
100000000011000001110111111111111
11110111111111011100000010001
11110111111111011101010010001
11000000110101011100000010001
100000000   00001100000010001
100000000   00000001010010000
11000001110001011111011110N01
10010001 1000101 101111010001
11111111 1111111 111111111111



