F 100,200,255
NO ./textures/ratt.png

WE ./textures/mossy.png
SO ./textures/barrel.png
EA ./textures/colorstone.png

C 100,200,255


        1111111111111111111111111
        1000000000110000000000001
        10110000001110000N0000001
        10010000000C0000000000001
111111111011000001110000000000001
100000000011000001110111110111111
11110111111111011100000010001
11110111111111011101010000001
11000000110101011100000010001
10000000000000001100000010001
10000000000000000O00000010001
11000001110001011111011110001  
10010001110001011101111010001
11111111111111111111111111111




010001
010001
010001
110N01
010001
111111
