1111011111
1000000001
1000000001
1000000001
10000N0001
1000000001
1000000001
1111011111